NO              ./xpm/wall1.xpm

    WE     ./xpm/wall2.xpm

 SO ./xpm/wall3.xpm


EA ./xpm/wall4.xpm

F     134, 81   ,      0

C 22,   163,247
         
        


        1111111111111111111111111
        1000000000110000000000001
        1011000001110000000000001
        1001000000000000000000001    
111111110011000001110000000000001          
100000000011000001110111001111111                  1
11110111111111011100000010001
11110111111111011101010010001
1100000111101 11100000010001       
10000001   111100110000000001      
10000001   100001101010000011                11111
11000001 11101011111011110N0111
11110111 1110101 101111010001
11111111 111111 1111111111111111111111 111111 11111111111111111111