NO              ./xpm/wall1.xpm

    WE     ./xpm/wall2.xpm

 SO ./xpm/wall3.xpm


EA ./xpm/wall4.xpm

F     108, 172   ,      1

C 22,   163,247
         

11111111111111111111111111111111111111111111111
11111111111110000303300030111111111111111111111
11111111111110303040030000111111111111111111111
11111111111110030333300300111111111111111111111
11111111111110000330300030111111111111111111111
11111111111110000333300030111111111111111111111
11111111111110000330300030111111111111111111111
11111111111111111121111111111111111111111111111
11111111111111111000111111111111111111111111111
11111111111111111101111111111111111111111111111
11111111111111111001111111111111111111111111111
11111111111111111100111111111111111111111111111
11111111111111111000111111111111111111111111111
11111111111111111101111111111111111111111111111
11111111111111111101111111111111111111111111111
11111111111111111001111111111111111111111111111
11111111111111111100111111111111111111111111111
11111111111111111000111111111111111111111111111
11111111111111111101111111111111111111111111111
11111111111111111001111111111111111111111111111
11111111111111111100111111111111111111111111111
11111111111111111000111111111111111111111111111
11111111111111111101111111111111111111111111111
11111111111111111001111111111111111111111111111
11111111111111111100111111111111111111111111111
11111111111111111000111111111111111111111111111
11111111111111111101111111111111111111111111111
11111111111111111001111111111111111111111111111
11111111111111111100111111111111111111111111111
11111111111111111000111111111111111111111111111
11111111111111111101111111111111111111111111111
11111111111111111001111111111111111111111111111
11111111111111111100111111111111111111111111111
11111111111111111000111111111111111111111111111
11111111111111111101111111111111111111111111111
11111111111111111001111111111111111111111111111
11111111111111111100111111111111111111111111111
11111111111111111000111111111111111111111111111
11111111111111111101111111111111111111111111111
11111111111111111001111111111111111111111111111
11111111111111111101111111111111111111111111111
11111111111111111001111111111111111111111111111
11111111111111111100111111111111111111111111111
11111111111111111000111111111111111111111111111
11111111111111111101111111111111111111111111111
111111111111111110N1111111111111111111111111111
11111111111111111111111111111111111111111111111