NO              ./xpm/no42.xpm

    WE     ./xpm/we42.xpm

 SO ./xpm/so42.xpm


EA ./xpm/ea42.xpm

F     108, 172   ,      1

C 22,   163,247
         
       
 11111111111111111111111111111111111111111111111111
 10000000000000010000000000000000000000000000000001
 10000000000000010000000020000000000000000000000001
 10010011111111111211111111111111111100001111111111
 11210000000000000000000000000000000100001
100010000000000000000000000000000000100001
100011111111111111111111111111111111121111
100000000000000100000100000000000000000001
100000000000000200000100000000000000000001
111111000000111110000111211111111111111111
100001000000100000000100000100000000000001
100001000001111100000100000100000000000001
100001111001000100000100121112111111110001
100000001002000100000100100000001000010001
100000011111000100000100200000001000020001
100000010000000100000111111111111001111111
100000010000000100000000000000001002000001
100000010001111100000000000000001111000001
100000010002000000000000000000000001000001
100000020001000000000000000000000001000001
100000011111000000000000000000000001000001
100000000000000000000000000000000001000001
10000000000000000000000000000000000200N001
111111111111111111112111111111111111111111
                 1000001
                 1000001
                 1110111
                 1110111
                 1111111