NO              ./xpm/no42.xpm

    WE     ./xpm/we42.xpm

 SO ./xpm/so42.xpm


EA ./xpm/ea42.xpm

F     108, 172   ,      1

C 22,   163,247
         
       
   11111111111111111111111111111111111111111111111
   10000030000000000000000000030000000000000000001
   10000000030000030000000030000000000000300000001
   1111100000030000000000000000000300000000000000111
       1000000110030000110000111111100000003000000001
       10030001100000001130111111111110003000000300001111111111111111111
       103000011000300011001100030001100000000001000001000003000000000001
       100030011101111111001100000001100001112111000010000000000300000001
   1111100000011121111111000003000011003000000000000002003000000000011111
   10030000300000300000110300000011100000003000030000010000000000001
11110001100030010030000110000011100000030000000000011111111111111111
103011000330000100000001100012111112111000030000001
10003001110030020000300000000300000000000000000001
11111103020012111121111111211111100000300001111111
   10001110300000003000002000030100030000001
   11103100001121112112111000003000000030001
   10300100301000000100003000000111111111111
   1121111000100300000000111111111
   1000002000300011111111
111103001110300011
1002301100301111
100000030000011
10001210301111
10011011111
10000000001
10000N0001
1111111111
