NO              ./xpm/wall1.xpm

    WE     ./xpm/wall2.xpm

 SO ./xpm/wall3.xpm


EA ./xpm/wall4.xpm

F     108, 172   ,      1

C 22,   163,247
         
       
   11111111111111111111111111111111111111111111111
   10000030000000000000000000030000000000000000001
   10000000030000030000000030000000040000300000001
   1111100000030000000000000000000300000000000000111
       1000000110030000110000111111100000003000000001
       10030001100000001130111111111110003000000300001111111111111111111
       10300001100030001100110003000110000000000100000100000030000000001
       100030011101111111001100004001100001112111000010000000343000000301
   1111100000011121111111000003000011003000000000000002000000030000011111
   10030000300000300000110300000011100000003000030000010000000000000000001
11110001100430010030000110000011100000030000040000011111111111111111111031
103011000330000100000001100012111112111000030000001                   1001
10003001110030020000300040000300000000000000000001                   10001
11111103020012111121111111211111100000300001111111                   10001
   10001110300000003000002000030100030000001                        10031
   11103100001121112112111000003000000030001                        10001
   10300100301000000100003000000111111111111                         10001
   1121111000100300000400111111111                                   10001
   1000002000300011111111                                             1001
111103001110300011                                                   10001
1002341100301111                                                    10031
100100030000411                                                     1001
10001210301111                                                     10001
10011011111                                                        10001
10001010001                                                        1301
10001010001                                                        1001
10001010001                                                        1001
10000000001111111111111111111111111111111111111111111111111111111110001
10000N0002000000000000000000030000000000000000000003000000000000000041
111111111111111111111111111111111111111111111111111111111111111111111
